#########################
#..........#............#
#....#######.....#......#
#....#...........#......#
#....#...#########......#
#................#......#
#....#.....#.....#......#
#....#.....#.....#.....O#
#########################